111111111111
1P00CCC00001
110000101111
1110CC000011
1CC0ECC00011
111000CCC011
111111111111
