1111111111111
1PC10100010C1
10000CC111001
101011E100001
1111111111111