1111111111111111111111111111
1E0010C000000000000000000001
1000111000000000000000000001
1000000000000000000000000001
1000000000000000000000000001
100C000000000000000000000001
1111111101111111111111101111
1111111101111111111111101111
1111111101111111111111101111
1111111101111111111111101111
1111111101111111111111101111
1111111101111111000111101111
1111111101111111000111101111
1111111101111111000111101111
1111111101111111000111101111
1111111100000000000111101111
1111111101111111000111101111
1111111101111111000111101111
1111111101111111000111101111
1111111101111111000111101111
1111111101111111000111101111
1111111101111111000111101111
1111111101111111000111101111
1111111111111111000111101111
1111100000011111000111101111
1111100000011111000111101111
1111100000011111000111101111
1111100000011111000111101111
11100000P0011111111111100011
1111111101111111000000001111
1111111100000000000111101111
1111111111111111111111111111